WWWWWWWWWWWWWWW
WW----M-------W
W----WWWWW----W
WW--WWWW---WW-W
WW-----WWWWWWWW
WWW--WWW-----WW
WWWW------WWWWW
WWW----W--W-WWW
WW--WWWWW-W--WW
WW----WW--W---W
WWW-W--------WW
WWWW--WW-W--WWW
WWWWWW----WWWWW
WWWWWWWGWWWWWWW
WWWWWWWWWWWWWWW